component_id,iteration,skip_iteration,cpu_time,cpu_time,name,elapsed
2,0,0,178517,233918,hologram,55401
2,1,0,294964,303437,hologram,8473
2,2,0,316484,319848,hologram,3364
2,3,0,324427,326194,hologram,1767
2,4,0,333212,336111,hologram,2899
2,5,0,340587,342281,hologram,1694
2,6,0,345267,347070,hologram,1803
2,7,0,349937,352576,hologram,2639
2,8,0,358732,362219,hologram,3487
2,9,0,367230,369061,hologram,1831
2,10,0,371965,373577,hologram,1612
2,11,0,376356,377924,hologram,1568
2,12,0,380780,382248,hologram,1468
2,13,0,385260,386913,hologram,1653
2,14,0,389690,391200,hologram,1510
2,15,0,394338,395885,hologram,1547
2,16,0,404426,409199,hologram,4773
2,17,0,420210,422016,hologram,1806
2,18,0,425244,426876,hologram,1632
2,19,0,429784,431277,hologram,1493
2,20,0,434023,435597,hologram,1574
2,21,0,438722,440172,hologram,1450
2,22,0,442970,445575,hologram,2605
2,23,0,448210,449823,hologram,1613
2,24,0,452458,453929,hologram,1471
2,25,0,457010,458655,hologram,1645
2,26,0,461734,463313,hologram,1579
2,27,0,466412,467769,hologram,1357
2,28,0,470744,472183,hologram,1439
2,29,0,475313,476808,hologram,1495
2,30,0,479824,481464,hologram,1640
2,31,0,484258,486041,hologram,1783
2,32,0,501383,508703,hologram,7320
2,33,0,517375,519255,hologram,1880
2,34,0,522225,523886,hologram,1661
2,35,0,526765,528403,hologram,1638
2,36,0,532029,533582,hologram,1553
2,37,0,536335,537744,hologram,1409
2,38,0,540426,542075,hologram,1649
2,39,0,545298,546900,hologram,1602
2,40,0,549922,551500,hologram,1578
2,41,0,554341,555946,hologram,1605
2,42,0,558779,560448,hologram,1669
2,43,0,563411,565042,hologram,1631
2,44,0,567968,569637,hologram,1669
2,45,0,572797,574388,hologram,1591
2,46,0,578249,579675,hologram,1426
2,47,0,582350,583734,hologram,1384
2,48,0,588349,590101,hologram,1752
2,49,0,593212,594801,hologram,1589
2,50,0,597879,599454,hologram,1575
2,51,0,602370,603946,hologram,1576
2,52,0,606603,608391,hologram,1788
2,53,0,611167,612798,hologram,1631
2,54,0,615588,617141,hologram,1553
2,55,0,620005,621540,hologram,1535
2,56,0,624528,626484,hologram,1956
2,57,0,629443,631056,hologram,1613
2,58,0,633726,635509,hologram,1783
2,59,0,638224,640008,hologram,1784
2,60,0,643155,644795,hologram,1640
2,61,0,647635,649155,hologram,1520
2,62,0,651931,653352,hologram,1421
2,63,0,656423,657915,hologram,1492
2,64,0,681617,693493,hologram,11876
2,65,0,706361,708327,hologram,1966
2,66,0,711585,713318,hologram,1733
2,67,0,717401,718984,hologram,1583
2,68,0,721718,723130,hologram,1412
2,69,0,727657,729552,hologram,1895
2,70,0,732632,734256,hologram,1624
2,71,0,737434,739067,hologram,1633
2,72,0,741975,743439,hologram,1464
2,73,0,746288,747860,hologram,1572
2,74,0,750829,752301,hologram,1472
2,75,0,755053,756637,hologram,1584
2,76,0,759124,760531,hologram,1407
2,77,0,763557,765015,hologram,1458
2,78,0,767848,769311,hologram,1463
2,79,0,772906,774362,hologram,1456
2,80,0,777071,778690,hologram,1619
2,81,0,781653,783079,hologram,1426
2,82,0,786095,787689,hologram,1594
2,83,0,790784,792446,hologram,1662
2,84,0,795383,796981,hologram,1598
2,85,0,799943,801388,hologram,1445
2,86,0,804238,805796,hologram,1558
2,87,0,808715,810347,hologram,1632
2,88,0,813138,814581,hologram,1443
2,89,0,817674,819159,hologram,1485
2,90,0,824454,826053,hologram,1599
2,91,0,829318,830741,hologram,1423
2,92,0,833400,834780,hologram,1380
2,93,0,837475,838884,hologram,1409
2,94,0,841826,843579,hologram,1753
2,95,0,846531,848291,hologram,1760
2,96,0,851138,852723,hologram,1585
2,97,0,855499,856873,hologram,1374
2,98,0,860119,861676,hologram,1557
2,99,0,864751,866384,hologram,1633
2,100,0,869253,870941,hologram,1688
2,101,0,873869,875268,hologram,1399
2,102,0,877952,880625,hologram,2673
2,103,0,883172,884755,hologram,1583
2,104,0,887408,889081,hologram,1673
2,105,0,891805,893209,hologram,1404
2,106,0,895964,897816,hologram,1852
2,107,0,900940,902552,hologram,1612
2,108,0,905625,907286,hologram,1661
2,109,0,910023,911404,hologram,1381
2,110,0,914327,915952,hologram,1625
2,111,0,918929,920420,hologram,1491
2,112,0,924978,926678,hologram,1700
2,113,0,929564,931266,hologram,1702
2,114,0,934132,935515,hologram,1383
2,115,0,939552,941000,hologram,1448
2,116,0,943793,945249,hologram,1456
2,117,0,947769,949345,hologram,1576
2,118,0,952122,953803,hologram,1681
2,119,0,956774,958372,hologram,1598
2,120,0,961426,963003,hologram,1577
2,121,0,965850,967486,hologram,1636
2,122,0,970212,971784,hologram,1572
2,123,0,974737,976218,hologram,1481
2,124,0,979133,980535,hologram,1402
2,125,0,983249,984870,hologram,1621
2,126,0,987672,990036,hologram,2364
2,127,0,992657,994242,hologram,1585
2,128,0,1034579,1056161,hologram,21582
2,129,0,1078870,1080887,hologram,2017
2,130,0,1083773,1085289,hologram,1516
2,131,0,1088055,1089599,hologram,1544
2,132,0,1092578,1094392,hologram,1814
2,133,0,1099454,1101270,hologram,1816
2,134,0,1104027,1105667,hologram,1640
2,135,0,1108289,1110065,hologram,1776
2,136,0,1112929,1114537,hologram,1608
2,137,0,1117432,1119102,hologram,1670
2,138,0,1121931,1123494,hologram,1563
2,139,0,1127359,1128811,hologram,1452
2,140,0,1131459,1132832,hologram,1373
2,141,0,1135471,1137100,hologram,1629
2,142,0,1140186,1141800,hologram,1614
2,143,0,1144607,1146337,hologram,1730
2,144,0,1149266,1150869,hologram,1603
2,145,0,1153667,1155237,hologram,1570
2,146,0,1158147,1159779,hologram,1632
2,147,0,1162683,1164324,hologram,1641
2,148,0,1167154,1168879,hologram,1725
2,149,0,1171669,1174339,hologram,2670
2,150,0,1177005,1178566,hologram,1561
2,151,0,1181170,1182665,hologram,1495
2,152,0,1185771,1187555,hologram,1784
2,153,0,1190442,1192033,hologram,1591
2,154,0,1196987,1198658,hologram,1671
2,155,0,1201385,1202974,hologram,1589
2,156,0,1205711,1207365,hologram,1654
2,157,0,1210203,1211817,hologram,1614
2,158,0,1214593,1216301,hologram,1708
2,159,0,1219159,1221229,hologram,2070
2,160,0,1224061,1225459,hologram,1398
2,161,0,1228235,1229746,hologram,1511
2,162,0,1232695,1234408,hologram,1713
2,163,0,1237547,1239286,hologram,1739
2,164,0,1242256,1243908,hologram,1652
2,165,0,1246818,1248244,hologram,1426
2,166,0,1251148,1252702,hologram,1554
2,167,0,1255751,1257206,hologram,1455
2,168,0,1260003,1261553,hologram,1550
2,169,0,1264381,1266057,hologram,1676
2,170,0,1269549,1271002,hologram,1453
2,171,0,1273697,1275129,hologram,1432
2,172,0,1277818,1279484,hologram,1666
2,173,0,1282439,1284024,hologram,1585
2,174,0,1286939,1288670,hologram,1731
2,175,0,1293370,1295117,hologram,1747
2,176,0,1298040,1299886,hologram,1846
2,177,0,1302756,1304275,hologram,1519
2,178,0,1307091,1308742,hologram,1651
2,179,0,1311853,1313521,hologram,1668
2,180,0,1317344,1318742,hologram,1398
2,181,0,1321536,1322979,hologram,1443
2,182,0,1325795,1327441,hologram,1646
2,183,0,1330613,1332204,hologram,1591
2,184,0,1335331,1336908,hologram,1577
2,185,0,1339851,1341258,hologram,1407
2,186,0,1344078,1345694,hologram,1616
2,187,0,1348787,1350276,hologram,1489
2,188,0,1353240,1354843,hologram,1603
2,189,0,1357607,1359074,hologram,1467
2,190,0,1362123,1363685,hologram,1562
2,191,0,1367114,1368552,hologram,1438
2,192,0,1371291,1372705,hologram,1414
2,193,0,1375385,1377033,hologram,1648
2,194,0,1380200,1381786,hologram,1586
2,195,0,1384889,1386433,hologram,1544
2,196,0,1389362,1390998,hologram,1636
2,197,0,1395876,1397471,hologram,1595
2,198,0,1400531,1402163,hologram,1632
2,199,0,1404938,1406442,hologram,1504
2,200,0,1409457,1410987,hologram,1530
2,201,0,1414462,1415858,hologram,1396
2,202,0,1418587,1420014,hologram,1427
2,203,0,1422696,1424102,hologram,1406
2,204,0,1426946,1428625,hologram,1679
2,205,0,1431762,1433352,hologram,1590
2,206,0,1436369,1437958,hologram,1589
2,207,0,1440937,1442347,hologram,1410
2,208,0,1445545,1446944,hologram,1399
2,209,0,1450011,1451465,hologram,1454
2,210,0,1454399,1456088,hologram,1689
2,211,0,1459183,1460781,hologram,1598
2,212,0,1464323,1465782,hologram,1459
2,213,0,1468515,1469948,hologram,1433
2,214,0,1472629,1474171,hologram,1542
2,215,0,1477208,1479002,hologram,1794
2,216,0,1481876,1483434,hologram,1558
2,217,0,1486546,1488123,hologram,1577
2,218,0,1492935,1494891,hologram,1956
2,219,0,1497872,1499576,hologram,1704
2,220,0,1502479,1504119,hologram,1640
2,221,0,1507156,1508624,hologram,1468
2,222,0,1512423,1513824,hologram,1401
2,223,0,1516649,1518064,hologram,1415
2,224,0,1520705,1522227,hologram,1522
2,225,0,1525436,1527068,hologram,1632
2,226,0,1530138,1531877,hologram,1739
2,227,0,1535117,1536771,hologram,1654
2,228,0,1539579,1540990,hologram,1411
2,229,0,1544009,1545489,hologram,1480
2,230,0,1548409,1549898,hologram,1489
2,231,0,1552640,1554223,hologram,1583
2,232,0,1557022,1558700,hologram,1678
2,233,0,1562502,1564059,hologram,1557
2,234,0,1566555,1568096,hologram,1541
2,235,0,1570697,1572219,hologram,1522
2,236,0,1575026,1576843,hologram,1817
2,237,0,1579803,1581414,hologram,1611
2,238,0,1584511,1586107,hologram,1596
2,239,0,1590786,1592719,hologram,1933
2,240,0,1595709,1597308,hologram,1599
2,241,0,1600273,1601732,hologram,1459
2,242,0,1604730,1606533,hologram,1803
2,243,0,1610556,1612113,hologram,1557
2,244,0,1614830,1616242,hologram,1412
2,245,0,1618997,1620682,hologram,1685
2,246,0,1623466,1625258,hologram,1792
2,247,0,1628207,1629937,hologram,1730
2,248,0,1632877,1634420,hologram,1543
2,249,0,1637297,1638673,hologram,1376
2,250,0,1641806,1643669,hologram,1863
2,251,0,1646570,1648086,hologram,1516
2,252,0,1650849,1652569,hologram,1720
2,253,0,1655599,1657252,hologram,1653
2,254,0,1660060,1661668,hologram,1608
2,255,0,1665105,1666463,hologram,1358
2,256,0,1742813,1781830,hologram,39017
2,257,0,1823532,1825877,hologram,2345
2,258,0,1829048,1830952,hologram,1904
2,259,0,1833744,1835412,hologram,1668
2,260,0,1838255,1839780,hologram,1525
2,261,0,1842842,1844825,hologram,1983
2,262,0,1847967,1849331,hologram,1364
2,263,0,1852138,1862187,hologram,10049
2,264,0,1866574,1868136,hologram,1562
2,265,0,1870933,1872505,hologram,1572
2,266,0,1875198,1877031,hologram,1833
2,267,0,1879762,1881418,hologram,1656
2,268,0,1884236,1885858,hologram,1622
2,269,0,1888594,1890294,hologram,1700
2,270,0,1893123,1894486,hologram,1363
2,271,0,1897144,1899816,hologram,2672
2,272,0,1902690,1904262,hologram,1572
2,273,0,1906911,1908363,hologram,1452
2,274,0,1911191,1912570,hologram,1379
2,275,0,1915396,1916980,hologram,1584
2,276,0,1919947,1921544,hologram,1597
2,277,0,1924708,1926357,hologram,1649
2,278,0,1929316,1930916,hologram,1600
2,279,0,1933681,1935285,hologram,1604
2,280,0,1938195,1939942,hologram,1747
2,281,0,1942818,1944283,hologram,1465
2,282,0,1947131,1948521,hologram,1390
2,283,0,1951531,1953333,hologram,1802
2,284,0,1957063,1958665,hologram,1602
2,285,0,1961428,1962871,hologram,1443
2,286,0,1965493,1967020,hologram,1527
2,287,0,1970085,1971919,hologram,1834
2,288,0,1975186,1976780,hologram,1594
2,289,0,1979681,1981225,hologram,1544
2,290,0,1984001,1985580,hologram,1579
2,291,0,1988515,1989993,hologram,1478
2,292,0,1992907,1994515,hologram,1608
2,293,0,1997313,1998839,hologram,1526
2,294,0,2001921,2003781,hologram,1860
2,295,0,2006786,2008261,hologram,1475
2,296,0,2011006,2012456,hologram,1450
2,297,0,2015408,2016889,hologram,1481
2,298,0,2020069,2021669,hologram,1600
2,299,0,2024844,2026458,hologram,1614
2,300,0,2029380,2031031,hologram,1651
2,301,0,2033790,2035342,hologram,1552
2,302,0,2038141,2039888,hologram,1747
2,303,0,2044862,2046641,hologram,1779
2,304,0,2050673,2052310,hologram,1637
2,305,0,2055050,2056497,hologram,1447
2,306,0,2059123,2060548,hologram,1425
2,307,0,2063219,2064901,hologram,1682
2,308,0,2068109,2069764,hologram,1655
2,309,0,2072581,2074289,hologram,1708
2,310,0,2077174,2078771,hologram,1597
2,311,0,2081596,2083167,hologram,1571
2,312,0,2086133,2087837,hologram,1704
2,313,0,2090674,2092152,hologram,1478
2,314,0,2094956,2096567,hologram,1611
2,315,0,2099094,2100409,hologram,1315
2,316,0,2103094,2104704,hologram,1610
2,317,0,2107568,2109703,hologram,2135
2,318,0,2112528,2113834,hologram,1306
2,319,0,2116511,2117953,hologram,1442
2,320,0,2121075,2122782,hologram,1707
2,321,0,2126035,2127651,hologram,1616
2,322,0,2130838,2132423,hologram,1585
2,323,0,2135356,2136951,hologram,1595
2,324,0,2139745,2141326,hologram,1581
2,325,0,2146509,2148262,hologram,1753
2,326,0,2151336,2153123,hologram,1787
2,327,0,2155954,2158811,hologram,2857
2,328,0,2161711,2163147,hologram,1436
2,329,0,2165733,2167257,hologram,1524
2,330,0,2170372,2172022,hologram,1650
2,331,0,2175100,2176858,hologram,1758
2,332,0,2179814,2181415,hologram,1601
2,333,0,2184153,2185658,hologram,1505
2,334,0,2188607,2190182,hologram,1575
2,335,0,2193116,2194716,hologram,1600
2,336,0,2197466,2198877,hologram,1411
2,337,0,2201859,2203314,hologram,1455
2,338,0,2207217,2208613,hologram,1396
2,339,0,2211341,2212718,hologram,1377
2,340,0,2215407,2217060,hologram,1653
2,341,0,2220084,2221677,hologram,1593
2,342,0,2224618,2226398,hologram,1780
2,343,0,2229261,2230628,hologram,1367
2,344,0,2233577,2235007,hologram,1430
2,345,0,2238201,2239721,hologram,1520
2,346,0,2244335,2245931,hologram,1596
2,347,0,2248834,2250438,hologram,1604
2,348,0,2253406,2255206,hologram,1800
2,349,0,2258183,2260518,hologram,2335
2,350,0,2263153,2264712,hologram,1559
2,351,0,2267363,2268819,hologram,1456
2,352,0,2271649,2273276,hologram,1627
2,353,0,2276357,2277959,hologram,1602
2,354,0,2281067,2282658,hologram,1591
2,355,0,2285630,2287263,hologram,1633
2,356,0,2289976,2291860,hologram,1884
2,357,0,2294744,2296227,hologram,1483
2,358,0,2299090,2300515,hologram,1425
2,359,0,2303574,2305040,hologram,1466
2,360,0,2307873,2309530,hologram,1657
2,361,0,2313007,2314469,hologram,1462
2,362,0,2317245,2318678,hologram,1433
2,363,0,2321324,2322775,hologram,1451
2,364,0,2325375,2326930,hologram,1555
2,365,0,2329506,2331138,hologram,1632
2,366,0,2334291,2335888,hologram,1597
2,367,0,2340796,2342408,hologram,1612
2,368,0,2345380,2346999,hologram,1619
2,369,0,2349935,2351573,hologram,1638
2,370,0,2354461,2355983,hologram,1522
2,371,0,2358996,2360488,hologram,1492
2,372,0,2363349,2364913,hologram,1564
2,373,0,2368008,2369902,hologram,1894
2,374,0,2372502,2374092,hologram,1590
2,375,0,2376699,2378110,hologram,1411
2,376,0,2380803,2382334,hologram,1531
2,377,0,2385340,2386967,hologram,1627
2,378,0,2390058,2391840,hologram,1782
2,379,0,2394746,2396293,hologram,1547
2,380,0,2399079,2400684,hologram,1605
2,381,0,2403579,2405231,hologram,1652
2,382,0,2408109,2409739,hologram,1630
2,383,0,2412649,2414077,hologram,1428
2,384,0,2416872,2418510,hologram,1638
2,385,0,2421468,2422989,hologram,1521
2,386,0,2425757,2428180,hologram,2423
2,387,0,2431079,2432520,hologram,1441
2,388,0,2435229,2436669,hologram,1440
2,389,0,2441052,2442792,hologram,1740
2,390,0,2445799,2447420,hologram,1621
2,391,0,2450507,2452089,hologram,1582
2,392,0,2454956,2456500,hologram,1544
2,393,0,2459446,2461044,hologram,1598
2,394,0,2463699,2465302,hologram,1603
2,395,0,2468106,2469826,hologram,1720
2,396,0,2472572,2474109,hologram,1537
2,397,0,2477021,2478707,hologram,1686
2,398,0,2481793,2483220,hologram,1427
2,399,0,2486010,2487988,hologram,1978
2,400,0,2491194,2492649,hologram,1455
2,401,0,2495279,2496694,hologram,1415
2,402,0,2499375,2500801,hologram,1426
2,403,0,2503485,2504945,hologram,1460
2,404,0,2507714,2509119,hologram,1405
2,405,0,2512109,2513895,hologram,1786
2,406,0,2516782,2518528,hologram,1746
2,407,0,2521558,2523092,hologram,1534
2,408,0,2526038,2527811,hologram,1773
2,409,0,2530899,2532624,hologram,1725
2,410,0,2537965,2539585,hologram,1620
2,411,0,2542780,2544519,hologram,1739
2,412,0,2547438,2549003,hologram,1565
2,413,0,2551720,2553135,hologram,1415
2,414,0,2555811,2557549,hologram,1738
2,415,0,2560225,2562025,hologram,1800
2,416,0,2564759,2566223,hologram,1464
2,417,0,2568990,2570331,hologram,1341
2,418,0,2573194,2574547,hologram,1353
2,419,0,2577621,2579015,hologram,1394
2,420,0,2583192,2584804,hologram,1612
2,421,0,2587443,2588840,hologram,1397
2,422,0,2591734,2593311,hologram,1577
2,423,0,2596248,2597819,hologram,1571
2,424,0,2600873,2602436,hologram,1563
2,425,0,2605329,2607079,hologram,1750
2,426,0,2610062,2611812,hologram,1750
2,427,0,2614689,2616114,hologram,1425
2,428,0,2618756,2620330,hologram,1574
2,429,0,2623157,2624852,hologram,1695
2,430,0,2627810,2629265,hologram,1455
2,431,0,2634118,2635681,hologram,1563
2,432,0,2638658,2640309,hologram,1651
2,433,0,2643127,2645900,hologram,2773
2,434,0,2648818,2650247,hologram,1429
2,435,0,2652814,2654277,hologram,1463
2,436,0,2657370,2659018,hologram,1648
2,437,0,2662101,2663650,hologram,1549
2,438,0,2666491,2668077,hologram,1586
2,439,0,2671211,2672799,hologram,1588
2,440,0,2675836,2677399,hologram,1563
2,441,0,2680132,2681646,hologram,1514
2,442,0,2684276,2686049,hologram,1773
2,443,0,2688737,2690397,hologram,1660
2,444,0,2693087,2694656,hologram,1569
2,445,0,2697560,2699064,hologram,1504
2,446,0,2702008,2704448,hologram,2440
2,447,0,2707294,2708995,hologram,1701
2,448,0,2711662,2713124,hologram,1462
2,449,0,2716009,2717727,hologram,1718
2,450,0,2720847,2722594,hologram,1747
2,451,0,2725527,2727079,hologram,1552
2,452,0,2730000,2731562,hologram,1562
2,453,0,2736871,2738538,hologram,1667
2,454,0,2741310,2742954,hologram,1644
2,455,0,2745717,2747378,hologram,1661
2,456,0,2750262,2751672,hologram,1410
2,457,0,2754507,2756178,hologram,1671
2,458,0,2759052,2761688,hologram,2636
2,459,0,2764348,2766062,hologram,1714
2,460,0,2768727,2770171,hologram,1444
2,461,0,2773041,2774525,hologram,1484
2,462,0,2777631,2779208,hologram,1577
2,463,0,2782257,2783801,hologram,1544
2,464,0,2786858,2788440,hologram,1582
2,465,0,2791250,2792809,hologram,1559
2,466,0,2795762,2797308,hologram,1546
2,467,0,2800095,2801708,hologram,1613
2,468,0,2804525,2806178,hologram,1653
2,469,0,2809060,2810478,hologram,1418
2,470,0,2813236,2814930,hologram,1694
2,471,0,2817951,2819607,hologram,1656
2,472,0,2823222,2824616,hologram,1394
2,473,0,2827372,2828796,hologram,1424
2,474,0,2833330,2835038,hologram,1708
2,475,0,2838262,2840015,hologram,1753
2,476,0,2843021,2844779,hologram,1758
2,477,0,2847731,2849343,hologram,1612
2,478,0,2852427,2854044,hologram,1617
2,479,0,2856879,2858294,hologram,1415
2,480,0,2861002,2862619,hologram,1617
2,481,0,2865618,2867281,hologram,1663
2,482,0,2870061,2871650,hologram,1589
2,483,0,2874449,2875873,hologram,1424
2,484,0,2878834,2881294,hologram,2460
2,485,0,2884105,2885482,hologram,1377
2,486,0,2888277,2889632,hologram,1355
2,487,0,2892254,2893686,hologram,1432
2,488,0,2896210,2897686,hologram,1476
2,489,0,2900712,2902494,hologram,1782
2,490,0,2905414,2906972,hologram,1558
2,491,0,2910051,2911606,hologram,1555
2,492,0,2914070,2915466,hologram,1396
2,493,0,2918640,2920150,hologram,1510
2,494,0,2923075,2924699,hologram,1624
2,495,0,2929360,2931117,hologram,1757
2,496,0,2934393,2936376,hologram,1983
2,497,0,2939441,2940931,hologram,1490
2,498,0,2943697,2945127,hologram,1430
2,499,0,2947741,2949174,hologram,1433
2,500,0,2951939,2953582,hologram,1643
2,501,0,2956582,2958354,hologram,1772
2,502,0,2961493,2963118,hologram,1625
2,503,0,2966080,2967581,hologram,1501
2,504,0,2970596,2972196,hologram,1600
2,505,0,2974978,2976571,hologram,1593
2,506,0,2979403,2980973,hologram,1570
2,507,0,2983534,2985134,hologram,1600
2,508,0,2988147,2989570,hologram,1423
2,509,0,2993454,2994883,hologram,1429
2,510,0,2997646,2999106,hologram,1460
2,511,0,3001674,3003079,hologram,1405
2,512,0,3147722,3217465,hologram,69743
2,513,0,3289316,3291397,hologram,2081
2,514,0,3295913,3297352,hologram,1439
2,515,0,3300005,3301476,hologram,1471
2,516,0,3304075,3305663,hologram,1588
2,517,0,3308289,3309723,hologram,1434
2,518,0,3312372,3313800,hologram,1428
2,519,0,3316391,3318190,hologram,1799
2,520,0,3320813,3322228,hologram,1415
2,521,0,3324863,3326303,hologram,1440
2,522,0,3329003,3330411,hologram,1408
2,523,0,3333107,3334552,hologram,1445
2,524,0,3337215,3338645,hologram,1430
2,525,0,3341310,3342752,hologram,1442
2,526,0,3345370,3346820,hologram,1450
2,527,0,3349345,3350789,hologram,1444
2,528,0,3353414,3354858,hologram,1444
2,529,0,3357526,3358954,hologram,1428
2,530,0,3361630,3363071,hologram,1441
